world_data = [[1, 1, 1, 1, 1, 1, 1, 1, 1, 1, 1, 1, 1, 1, 1, 1, 1, 1, 1],
              [1, 0, 0, 0, 0, 0, 0, 0, 0, 0, 0, 0, 0, 0, 0, 0, 0, 0, 1],
              [1, 0, 0, 0, 0, 0, 0, 0, 0, 0, 0, 0, 0, 0, 0, 0, 0, 0, 1],
              [1, 0, 0, 0, 0, 0, 0, 0, 0, 0, 0, 0, 0, 0, 0, 0, 0, 0, 1],
              [1, 0, 0, 0, 0, 0, 0, 0, 0, 0, 0, 7, 6, 0, 0, 0, 0, 0, 1],
              [1, 0, 0, 0, 0, 0, 0, 0, 0, 0, 0, 2, 2, 0, 0, 0, 0, 0, 1],
              [1, 3, 7, 0, 0, 0, 0, 7, 3, 7, 0, 0, 0, 0, 0, 7, 0, 0, 1],
              [1, 2, 2, 7, 0, 0, 0, 2, 2, 2, 0, 0, 0, 0, 2, 2, 0, 0, 1],
              [1, 0, 0, 8, 7, 0, 0, 0, 0, 0, 0, 0, 7, 5, 0, 0, 0, 0, 1],
              [1, 0, 0, 2, 2, 0, 0, 0, 0, 0, 7, 7, 2, 2, 0, 0, 0, 0, 1],
              [1, 0, 0, 0, 0, 0, 7, 3, 7, 7, 2, 2, 2, 2, 0, 0, 0, 0, 1],
              [1, 0, 0, 0, 0, 7, 2, 2, 2, 2, 2, 2, 0, 0, 0, 0, 7, 7, 1],
              [1, 0, 0, 0, 2, 2, 0, 0, 0, 0, 0, 0, 0, 0, 0, 0, 2, 2, 1],
              [1, 0, 7, 7, 0, 0, 0, 0, 0, 0, 0, 0, 0, 0, 0, 0, 0, 0, 1],
              [1, 2, 2, 2, 0, 0, 0, 0, 0, 0, 0, 0, 0, 0, 0, 0, 0, 0, 1],
              [1, 1, 1, 1, 1, 4, 4, 4, 4, 4, 4, 4, 4, 4, 4, 1, 1, 1, 1],
              [1, 1, 1, 1, 1, 1, 1, 1, 1, 1, 1, 1, 1, 1, 1, 1, 1, 1, 1]]