world_data = [[1, 1, 1, 1, 1, 1, 1, 1, 1, 1, 1, 1, 1, 1, 1, 1, 1, 1, 1],
              [1, 0, 0, 0, 0, 0, 0, 0, 0, 0, 0, 0, 0, 0, 0, 0, 0, 0, 1],
              [1, 0, 7, 0, 0, 0, 0, 0, 0, 0, 0, 0, 0, 0, 0, 0, 7, 6, 1],
              [1, 0, 2, 2, 0, 0, 0, 0, 0, 3, 0, 2, 2, 0, 7, 0, 2, 2, 1],
              [1, 0, 0, 0, 0, 0, 0, 0, 2, 2, 0, 0, 0, 0, 2, 0, 0, 0, 1],
              [1, 0, 0, 0, 0, 7, 0, 0, 0, 0, 0, 0, 0, 0, 0, 7, 7, 5, 1],
              [1, 7, 0, 0, 0, 2, 2, 0, 0, 0, 7, 0, 0, 7, 7, 2, 2, 2, 1],
              [1, 2, 2, 0, 0, 0, 0, 0, 0, 7, 0, 0, 0, 2, 2, 0, 0, 0, 1],
              [1, 0, 0, 0, 0, 0, 0, 0, 2, 2, 2, 0, 0, 0, 0, 0, 0, 0, 1],
              [1, 0, 0, 0, 0, 3, 8, 7, 0, 0, 0, 7, 0, 0, 0, 0, 0, 0, 1],
              [1, 0, 0, 0, 2, 2, 2, 2, 0, 0, 2, 2, 2, 0, 0, 0, 7, 7, 1],
              [1, 0, 0, 0, 0, 0, 0, 0, 0, 0, 0, 0, 0, 0, 0, 2, 2, 2, 1],
              [1, 0, 0, 0, 0, 7, 0, 7, 0, 0, 0, 0, 0, 0, 0, 0, 0, 0, 1],
              [1, 0, 0, 0, 0, 2, 0, 2, 0, 0, 0, 7, 0, 3, 0, 0, 0, 0, 1],
              [1, 1, 1, 1, 4, 4, 4, 4, 4, 1, 1, 1, 1, 1, 1, 1, 1, 1, 1],
              [1, 1, 1, 1, 4, 4, 4, 4, 4, 1, 1, 1, 1, 1, 1, 1, 1, 1, 1],
              [1, 1, 1, 1, 1, 1, 1, 1, 1, 1, 1, 1, 1, 1, 1, 1, 1, 1, 1]]
