world_data = [[1, 1, 1, 1, 1, 1, 1, 1, 1, 1, 1, 1, 1, 1, 1, 1, 1, 1, 1],
              [1, 0, 0, 0, 0, 0, 0, 0, 0, 0, 0, 0, 0, 0, 0, 0, 0, 0, 1],
              [1, 0, 0, 0, 0, 0, 0, 0, 0, 0, 0, 0, 0, 0, 0, 0, 0, 0, 1],
              [1, 0, 0, 0, 0, 0, 0, 0, 0, 0, 0, 0, 0, 0, 0, 0, 0, 0, 1],
              [1, 0, 0, 0, 0, 0, 0, 0, 0, 0, 0, 0, 0, 0, 0, 0, 0, 0, 1],
              [1, 0, 0, 0, 0, 0, 0, 0, 0, 0, 0, 0, 0, 0, 0, 0, 0, 0, 1],
              [1, 0, 0, 0, 2, 7, 0, 0, 0, 0, 0, 0, 0, 7, 2, 0, 0, 0, 1],
              [1, 0, 7, 0, 0, 2, 7, 0, 0, 0, 0, 0, 7, 2, 0, 0, 8, 5, 1],
              [1, 0, 2, 0, 7, 0, 2, 3, 7, 6, 7, 3, 2, 0, 7, 0, 2, 2, 1],
              [1, 0, 0, 0, 2, 0, 0, 2, 2, 2, 2, 2, 0, 0, 2, 0, 0, 0, 1],
              [1, 0, 7, 0, 0, 0, 0, 0, 0, 0, 0, 0, 0, 0, 0, 0, 7, 0, 1],
              [1, 0, 2, 0, 7, 0, 0, 0, 0, 0, 0, 0, 7, 0, 0, 0, 2, 0, 1],
              [1, 0, 0, 0, 2, 0, 0, 0, 0, 0, 0, 0, 0, 0, 2, 0, 0, 0, 1],
              [1, 0, 7, 7, 0, 0, 0, 0, 7, 3, 0, 0, 0, 7, 3, 7, 0, 0, 1],
              [1, 2, 2, 2, 2, 0, 0, 2, 2, 2, 0, 0, 2, 2, 2, 2, 0, 0, 1],
              [1, 1, 1, 1, 1, 4, 4, 4, 4, 4, 4, 4, 1, 1, 1, 1, 4, 4, 1],
              [1, 1, 1, 1, 1, 1, 1, 1, 1, 1, 1, 1, 1, 1, 1, 1, 1, 1, 1]]