world_data = [[1, 1, 1, 1, 1, 1, 1, 1, 1, 1, 1, 1, 1, 1, 1, 1, 1, 1, 1],
              [1, 0, 0, 0, 0, 0, 0, 0, 0, 0, 0, 0, 0, 0, 0, 0, 0, 0, 1],
              [1, 0, 0, 0, 0, 0, 0, 0, 0, 0, 0, 0, 0, 0, 0, 0, 0, 0, 1],
              [1, 0, 0, 0, 0, 0, 0, 0, 6, 7, 0, 0, 0, 0, 0, 0, 0, 0, 1],
              [1, 0, 0, 0, 7, 7, 0, 2, 2, 2, 0, 0, 0, 0, 0, 3, 7, 7, 1],
              [1, 0, 0, 2, 2, 2, 0, 0, 0, 0, 7, 3, 0, 0, 0, 2, 2, 2, 1],
              [1, 5, 7, 0, 0, 0, 7, 7, 0, 2, 2, 2, 0, 0, 7, 0, 0, 0, 1],
              [1, 2, 2, 0, 0, 0, 2, 2, 0, 0, 0, 0, 0, 2, 2, 2, 0, 0, 1],
              [1, 0, 0, 3, 7, 0, 0, 0, 0, 0, 0, 0, 7, 0, 0, 0, 0, 7, 1],
              [1, 0, 2, 2, 2, 0, 0, 0, 0, 7, 0, 2, 2, 0, 0, 7, 0, 2, 1],
              [1, 0, 0, 0, 0, 8, 7, 0, 2, 2, 0, 0, 0, 0, 2, 2, 0, 0, 1],
              [1, 0, 0, 0, 0, 2, 2, 0, 0, 0, 0, 0, 0, 0, 0, 0, 0, 0, 1],
              [1, 0, 0, 0, 0, 0, 0, 0, 0, 0, 0, 2, 2, 0, 0, 0, 2, 2, 1],
              [1, 0, 7, 7, 0, 0, 0, 0, 2, 2, 0, 0, 0, 0, 0, 0, 0, 0, 1],
              [1, 2, 2, 2, 4, 4, 4, 4, 4, 4, 4, 4, 4, 4, 4, 4, 4, 4, 1],
              [1, 1, 1, 1, 1, 1, 1, 1, 1, 1, 1, 1, 1, 1, 1, 1, 1, 1, 1],
              [1, 1, 1, 1, 1, 1, 1, 1, 1, 1, 1, 1, 1, 1, 1, 1, 1, 1, 1]]